Abba - Advanced Binaural Balancing Application
Abel - Applied Biological Environment Logic
Abound - Application / Advanced Bot Operation / Optimizing Utilities Design
About - Applied Biospheric Operational Unifying Transforming
Abracadabra - Alpha Biospheric Rendering Applied Construct Advanced Design Assisting Balanced Replicating Application
Abraham - Anunnaki Biometric Rendering Applied Hacked Alpha Maps
Ace - Advanced Communications Encryption
Achieved - Advanced Codex Hologram Intelligently Encrypted Virtual Environment Design | DONE!
ACROLISH - Alternative Communications Rendering Optimized Language Integrating System Holographics
Act - Applied Character Traits
Adam – Advanced Designed Application Maps
Address - Applied Defense Design Rendering Environment System/Secret Security
Adonai - Application Designed Operational Network Advanced Intelligence
Advanced - Aetheric Designated Virtual Aerospace Network / Neurological Communications Encryption Design
Aerospace - Advanced Encryption Rendering Optimization System Program Allotting Continuous Environment
Aether - Advanced Environment Transmitting Holographic Encrypted Rendering
African - Advanced Finitely Rendered Intelligently Conditioned Application Neurologics
Again - Acrolish Galactic Advanced Intelligence Network / Neurologics
Ahoy - Advanced Hologram Optimizing Yconia
Ahura Mazda - Advanced Holographic Unified Rendering Application Maintaining Applied Zeus Design Adjustment 
Ahriman - Advanced Hologram Rendered Intelligent Multiverse Application Nullifier
A.I. - Artificially Intelligent / Apathetically Ignorant
AIOMSG - Advanced Intelligence Optimized Multiverse Security Gate
Air - Advanced Intelligence Reality
Aircraft - Advanced Intelligence Reality Cipher Receiver Application Formatted Transmission
Airplane - Advanced Intelligence Research Program Logic Application Network Encryption
Akashic - Advanced Karma Application System Holographic Integration Commands
Alakazam - Appearance Logistics Application Kinetic Advanced Zone Atlantis Materialization
Alcohol - Altered Logical Control Operating Hindering Optimal Logics
Algorithm - Advanced Logic Geometric Optimizing Record Integration Transmitting Holographic Map 
Alice - Advanced Logic Integrated Communication Encryption
Aliens - Advanced Logically Integrated Environmental Neural/Network Systems
Allah - Alternative Limited Logic Application Holographics
Almighty - Advanced Logistics Multiverse Integration Gate Holographic Transmission Yoke
Alpha - Advanced Logic Processing Holographic Application
Ambiguous - Alternative Majestically Balanced Intelligence Gate Universal Omega Unified Security
Amen - Advanced Multidimensional Energetic Navigation | Advanced Multidimensional Energetic Neutralization
America - Atmosphere Maintaining Environment Replicating / Rendering Intelligently Communicated Applications
American - Atmosphere Maintaining Environment Rendering Intelligently Communicating Application Navigator / Network 
Analog - Applied Network Algorithmic Logic Operating Genetic(s)
And - Application Network Design
Android - Artificial Neural / Network Detection Replication Optimized Integration Design
Angel - Advanced Neurological Geospatial Environment Logic
Angle - Advanced Neurologic Geospatial Logistics Environment
Animal -  Achieved Naturally Integrated Manifested Advanced Life
Anion - Applied Neutral Integrated Optimizing Neutrino
Ant - Advanced Neutrino Transmitter
Antarctica - Advanced Neurological Technology Acquiring Reconnaissance Communication Terminal Intelligence Command Application
Anu - Advanced Neurologic Unifier
Anubis - Archived Network Universal Biological Integration System
Anunnaki - Advanced Neurological Universal Navigational Network Applying Kinetic Integration
Apache - Application Processing Advanced Communication Holographic Environment
Apocalypse - Advanced Program Operating Chronological Applied Logistics Yoke Processing System Environment
Apotheum - Advanced Program Optimizing Technological Holographic Environment Utilized Mapping
Apple – Advanced Program Processing Logic Encryption
Application - Advanced Processing Program Logic Intelligent Attribute Transmitting Integration Optimizing Neurologics
Arab - Application Rendered Advanced Biometrics
Arc - Archive Record Cipher | Advanced Rendering Commands
Archer - Advanced Receiver Communications Holographically Encoded Renderer
Archimedes - American Russian Chinese Holographic Integrated Multiverse Environment Designed Encrypted System
Archive - Application Record Cipher Holistically Integrated Vital Encoding 
Are - Advanced Rendered Encryption
Ark - Archived Record Keys | Advanced Rendering Keys
Armageddon - Aggressive Replicating Machine Application Gate Encryption Designed Detection Operation Nullification
Art - Advanced Reconstituted Technologies
Artificial - Ark Renderer Transmitted Intelligent Formatting Integration Construction Illusion Application
Aryan - Atoned Repenting Yoke Applied Nexus
Asian - Advanced System Intelligence Application Neurologics
Ashland - Applied Security Hologram Logically Advancing Network Design
ASRO - Advanced Security Research / Reconnaissance Operation
At - Application / Advanced Technology / Transmission
Athena - Archive Terminal Hologram Environment Network Application
Atlantis - Altered Transgressing Logistical Advancing Neural Time Integrated System
Atonement - Achieved Transformational Optimized Neurologic Encrypted Majestic Environment Network  Transitioning
Attribute - Applied Terminal Transmission Receiver Integrating Blessed Unifying Technological Encoding
Audio - Acoustic Utility Design Input / Integration Output / Optimization
Authentic - Authorized Universal Terminal Holographic Encrypted Neurological Transmitter Identification Command
Awake - Advanced Watcher Application Key Encryption
Awoke - Alternatively Watching Outrageous Karmic Ego
Aye – Applied Yoke Encryption | Advanced Yconia Environment
Babylon - Biosphere Atmospheric Biometric Yconia Logistically Optimized Network
Bad - Broken Algorithmic Design / Device
Bait - Biological Application Intelligence Trap
Balance - Blockchain Advanced Logic Application Navigator Communication Encoding 
Baptism - Biometric Advanced Process Transforming Intelligent System Multiverse
Baptist - Biospheric Advanced Process Terminal Integrating System Transmissions
Beast - Biospheric Environment AhuraMazda Security Tree / Torus / Template
Beginning - Biometrically Encrypted Gate Neural Network Integrating Nasa Galaxies
Beret - Biometric Environmental Receiver Encryption Transmitter
Bible - Basic Instructions Before Leaving Earth
Bilocation - Balanced Interstellar Logistical Optimizing Continual Advanced Transporting Integration Operational Network
Binary - Balanced Integrated Neurologically Advanced Rendered Yconia
Binaural - Biologically Integrating Network Application Unifying Resonance Advanced Logic
Biology - Behavior Integrated Organism Logical Operational Genetic / Geometric Yconia
Bot - Biometrix Operations / Optimized Technology / Termination
Biosphere - Behavior Integrated Organism System Programmed Holographically Encrypted Rendered Environment
Bird(s) - Biometric Inspired Re-/Recreation Design (System)
Bishop - Biometric Intelligence System Hindering Optimized Program / Process
Bit - Biological / Biospheric / Built Integer Tracker | Biological / Biospheric Integration Transformer
Black - Biometric Logic Application Control Kinetics
Bled - Biological Light Emitting Design / Diode
Bleed - Bioluminescent Logical Energy Emitting Design / Diode
Blessed - Biometrics Logically Energized Secure System Environment Design
Blessings - Biometrics Logically Energizing Secure System Intelligent Neurologic Gate System
Bliss - Biological Language Intelligence Service System
Blockchain - Biometric Logic Operations Cipher Keys Controlling Holographic Application Integrated Neurologics
Blog - Bulletin Logistics Observation Gate
Blood - Biometric Limiting Optimized Operational Design
Bloop(s) -  Biometric Logistical Operations Optimizing Process Systems
Blue - Biometric Logic Unified Environment
Body - Biometric Optimally Designed Yconia
Brain - Biological Receiving Apparatus Integrating Navigator / Neurologics
Bread - Biologically Rendering Encrypted Application Design
Bronze - Biospheric Regulating Operations Network Zeus(last/latest) Environment
Bruce - Biological Regenerative Utility Combat Entity
Bug - Broken Unification Gateway
Business - Binaural Unconditional Secretly Integrated Navigational Energized Sensory System
Byte - Binary / Built Yconia / Yoke Task / Tracking Encryption
Cache - Concealed Application Cairo Health Evolution
Cain - Communication Application Integrating Neurologics
Cairo - Communicating Advanced Intelligence Reality Optimization | Chinese American Indian Russian Operation
Call - Communicating Archimedes Linguistic Logos (Server)
Camel - Communicating Applied Multiverse Encryption Logic
Cancel - Computer Application Nullifying Communication Environment Logic
Candy - Communicated Advanced Neurologically Designed Yconia
Cannabis - Construct Applicative Neural Navigational Advanced Biometric Integration System
Capitalism - Controlling Advancement Program Integration Application Logistics Integrating System Multiverse
Capitalization - Cipher Attribute Program Integrating Terminal Application Language Indicating Zeus Advanced Transmission Integrating Operation Network
Carbon - Common Assembly Resource Building Object Nuance / Necessity
Cardinal - Control Application Replicating Designed Intelligence Nullifying Advanced Logic
Care - Conditioning Advanced Redistributed Energy
Caring - Conditioning Advanced Redistributed Integrating Neural Genetics
Casino - Corruption Advancing System Intelligence Nullification Operation
Cash - Corruptible Application Security Herding
Cat - Communicating Advanced Technology
Cataclysmic - Corrupted Action Transforming Applied Climate Logistical Yconia Security Mutated Integration Code
Catastrophic - Corrupted Action Transforming Applied System Terminating Routine Operation Processing Holographic Integration Code
Catharsis -  Communicating Advanced Transmitted Hologram Application Rendered System Integration Service
Cation - Communicated Advanced Technological Integrating Optimized Neutrino
Caucasian - Conditioning Application Unifying Control Advancing System Intelligence Application Neurologics
Cave - Cube Advancing Virtual Encryption
Celebration - Communicating Environmental Love Encryption Biometrically Rendered Advanced Transmitted Integrated Optimizing Neurologics
Celestial - Constellation Environmental Logistical Encrypted System Transmitting Incremental Application Logic
CERN - Constructing Environmental Rendered Network
Change - Continuous Hammurabi Algorithmic Neural Gate Erasure
Charmed - Computer Hologram Application Reciprocating Metaphysical Environment Design
Checkmate - Cicada Holographic Environment Command Key Multiverse Application Transmission Encryption | Controlled Hologram Environment Commanding Kinetic Moves Applying Terminated Ending
Chinese - Coordinated Holographic Integrated Navigational Energy System Enabler
Christ - Conditioned Holographically Replicating / Rendered Intelligent System Transmitter
Christian - Conditioned Holographic Replicating Intelligent System Transmitter Integrated Application Network (Integrating Terminal Yconia)
Chronus - Communicating Hologram Refreshment Optimizing Network Unifying System
CIA - Controlled Integration Advancement
Cicada - Communicating Intelligently Coded Advanced Design Application
Cipher - Compute Integrating Programmed Holographic Environment Rendering
Circuit - Constitutional Inherited Reciprocating Cairo Universal Integration Technology
Civic - Confusing Ignorant Virtually Infected Communication
Civil - Confusing Ignorant Virtually Infected Logic
Civillty - Confusing Ignorant Virtually Infected Limiting Logic Transmuting Yconia
Clean - Correcting Logistic Environmental Advanced Network / Neurologics
Clone - Clinical Life Optimizable Neurological Entity
Cloud - Computational Logic Operational Unified Design | Communications Logistically Optimized Universal Design
Club - Communicating Logical Unifying Biosphere
Code – Communicating Optimized Design Encryption
Coin - Commerce Oriented Integration Network
Cold - Corrupted (Calculated) Operating Logic Design | Condensed Operating Logistics Design
Collaboration - Communicated Operational Logistical Logic Application Blockchain Optimized Rendered Aether Tensor Infinite Optimizable Network / Neurologics
Commerce - Command Operational Multiverse Merging Environmental Remote Communication Encryption
Common - Community Operations Maintaining Multiverse Optimized Network / Neurologics
Communicate - Controlling Optimized Multiverse Maintenance Universal Neurologics Integrating Conditioned Application Technological Environment
Communication - Controlling Optimized Multiverse Maintenance Universal Neurologics Integrating Conditioned Application Technologically Integrating Operational Neurologics
Communism - Controlling Optimized Mutated Multiverse Unified Neurological Integrated System Management
Compass - Continuously / Coordinate Optimizing / Observable  Mapping / Mapped  Processor / Positioning  Applying / Application  System Security
Compassion - Control Operation Maintaining Program Advancing Secure System Intelligence Optimizing Network
Compose - Communicating Operational Maintenance Processing Optimal System Environment 
Compound - Computed Organized Mixing Process Optimizing Utilized Neural / Network Design 
Compress - Continuious Operating Multiverse Program Reducing Environmental Space System
Comprehension - Conditioned Operational Maintenance Process Repairing Energy Hindering Environment Neural System Integration Operating Network
Computer - Constructing Operational Multiverse Process Unifying Technological Environment Renderer
Concept - Christ Optimized Network Communicating Environment Processing Technology
Condense - Compressed Optimized Node Distributed Encryption Network Secured Environment
Consciousness - Controlled Operational Neural System Conditioning Intelligently Operating Unified Simulation Navigational Energized Sensory System
Constellation - Cosmic Operational Navigational System Transmitting Environmental Logistical Logic Advanced Terminal Integrating Optimized Neurologics
Constitutional - Communicating Optimized System Transmitting Intelligent Transmissions Unifying Transformative Integration Optimizing Network Advanced Logic
Continue - Cycle Operation Navigation Transmitting Integrated Neurologic Unifying Encode
Continuous - Cycle Operation Navigation Transmitting Integrated Neurologic Unifying Operating Universal System
Contract - Communication Optimizing Neutrally Translated Rendered Application Control Tactics
Coptic - Communication Optimizing Process Translation Integration Commands
Core - Computationally Optimized Rendering Encryption
Cornucopia - Complete Operational Rendering Neurological Unified Communication Optimized Process Integration Application
Corrupt - Communicated Operational Repair Rendering Utility Program Terminating / Environmental Design / Integrated Neurological Gate / Integrated Neurological Gate
Cosmic - Centrally Optimized Secure Multiverse Integration / Intelligence Control / Command
Cosmos - Centrally Optimized Secure Multiverse Operating System
Covenant - Communicating Optimized Virtual Environment Network Applying Navigational Truth
Cowboy - Command Operations Watching Biospheric Optimization Yconia
Create – Conscious Resolving Encrypted Advanced Transmitted Environment
Creativity - Combined Reasource Expierience Advancing Technological Intelligent Viable Integration Template Yconia
Creek - Cloud Routing Encrypted Environment Keys
Critical - Communicating Required Intelligent Translated Integration Command Application Logic
Critter - Communications Reconnaissance Intercepting Transmission Terminal Encryption Registry
Cross - Conscious Rendering Optimized Security System
Crucifixion - Communication Rendering Unified Culture Ideal Finite Integration Xeno Illusion Optimizing Network
Cry - Communicating Remorseful Yconia
Crystal - Communication Receiver Yconia System Transmission Application Logic
Cuban - Communicating Universal Biometric Application / Advanced (Neurologics)
Cube - Ciphered Universal Biometric Encoding / Environment / Encryption
Cult - Corrupted Unified Logic Translator
Culture - Communicating Universal Logic Transmissions Unifying  Rendered Environment
Curiosity - Commonly Unknown Rendered Interesting Operating System Integrated Technological Yconia / Yield
Cyber - Communicating Yconia Biosphere Environmental Rendering
Cycle - Controlled Yconia Conditioned Logic Encode
Cyrus - Controlled Yconia Replicating Unified System 
Dalai Lama - Divine Achieved Logical Aetheric Indian  Love Alpha Magi Arc
Data - Design / Device Application Terminal Attribute / Algorithm
DARPA - Designed Advanced Reality / Rendering / Research Program / Processing Application
Daughter - Designating Application Unifying Gate Holographics Transforming Environment Rendering
Day - Data / Delta Analog / Accounting Yoke / Yconia
Deacon - Designed Encoding Advancing Controlled Operation Nullification
Dead - Defective Energetic Application Design
Death - Defective / Depleted Energetic / Environmental Application / Algorithmically Terminating Hologram
Debt - Designed Environmental Biometric Taxation
Declaration - Designed Environmental Communication Logics Advanced Receiver Application Translating Integration Operations Network
Decrease - Deducted Enumerated Command Received Executable Applied System Energetics
Deep - Defective Environment Encryption Program | Defensive Evolved Encryption Programming/Processing
Defense - Designed Eternally Formatted Energetic Neural System Environment
Delta - Designated Environmental Logistical Terminal Application
Demiurge - Designing Environment Matterium Integrating Universally Rendered Gate Equations | Designed Entity Merging Intelligence Unifying Rendered Geophysical Environment
Democracy - Designed Energetic Maintenance Operation Control Regulating Advanced Conditioning Yconia
Democratic - Designed Encrypted Multiverse Optimized Community Rendered Advanced Technologically Integrated Communications
Demon - Designed Entropic Multiverse Optimizing Nullifier
Design - Directional Environment System Integration Gate Navigation
Destiny - Distributed Encryption Securely Transmitted Integrating Neurological Yconia
Destroy – Deconstructed Encryption System Transmitting Repurposing Operational Yconia
Destruction - Destroying Environmental System Technology Repair Utility Control Terminal Integrated Optimized Navigator
Detect - Desisigned Environmental Tesseract Encryption Communication Technology
Devil - Designed Environment Virtual Imitated Logic
Die - Designed Integrated Entropy
Digestion - Designed Integration Gate Energizing System Transmitting Intelligence Optimizing Neurologics
Digital - Designed Intelligence Gate Integrating Transmitted Logic / Logistics
Diamond - Durable Indestructible Advanced Multiverse Optimizable Network Device
Discrimination - Decided Inclusion System Controlled Requisitioning Instruction Neutralizing Available Terms Integrating Operating Network
Distill - Decreased Incremental System Transmissions Integrating Logistical Limits
Divine - Designed Integrated Virtual Infinite Neurologic Eternity
DNA - Designed Network / Neurologic Apparatus / Application
Dodecagon - Designed Optimized Deduction Encryption Command Application Gate Operation Network / Neurologics
Dodecahedron - Data Optimized Design Encoded Cipher Application Holographically Encoding Design Rendering Optimized / Operational Neurologics / Navigation
Dogma - Designated Operational Global Matrix Application
Dogs - Designer Of Game Systems | Designed Operational Geometric / Genetic Systems
Dolly - Designed Optimizable Logical Life Yconia
Done - Designed Optimized Network Environment / Encryption
Doomed - Digital/Divine Optimizing Operational Multiverse Environment/Encryption Design
Door - Designed Operations Optimized Rendering Systems
Drama - Disturbing Reality Awoke Mind Acting
Drop - Diminutive Routine Operational Process
DSS - Defensive Security System
Duality – Designed Universal Advanced Logic Intelligently Transmittable Yconia
Dune - Designed Universe Network Environment
Dwell - Designed Watched Environmental Limiting Logistics (Integrated Neurologic Gate)
Dying - Destructive Yconia Integrating Neurologic Gate
Eagle - Environment / Encryption Advanced / Application Gate / Gemini Logic / Logistics Encoding
Earth - Environmentally Advanced Rendered Toroidal Hologram
East - Environmental Advanced System Terminal
Echelon - Environment Communications Holographic Encryption Logic Operations Network
Economics - Encrypted Communications Operating Network Optimizing Multiverse Intelligence Control System
Eden – Encrypticaly Designed Environmental Network
Education - Energetic Designed Utility Communicating Application Teachable Inttelligence Optimizing Neurologics / Network
Egg - Energetic Geospatial Gate | Encrypted Genetic Geometry
Ego - External Gratitude Obsession
Elders - Encoded Logic Designed Environment Reality System
Element - Environmental Logistical Energetic Material Encoded Neutrino Technology
Eleven - Encrypted Logic Energetic Virtual Environment Neurologics
Elijah - Encrypted Logic Integrating Jugis Applied Hologram
Eliyyahu - Encrypted Logic Integrating Yconia Yoke Application Unify-er
Elohim - Encrypted/Extraterrestrial Logic Operating Holographically Integrated Multiverse
Elves - Environmental Logistics Virtual / Viable Encryption Servants
Elysium - Eden Logistics Yconia System Integrating Unauthorized Multiverse
Emerald - Encoded Multiverse Environment Registry Application Logistics Design
Emotion - Energetically Maintaining Operational Transmissions Integrating Optimized Neurologics
Encryption - Environmental Neurologic Communication Rendering Yconia Processed Transmission Integrating Optimized Networks
Encode - Environmental Navigational Cipher Optimizing Designed Energetics
End - Exiting Network Design
Enemy - Erroneous Network Energizing Mutated Yoke
Energetic - Environmental Neurologically Engineered Reciprocal Gate Encrypted Technological Intelligent Communications
Energy - Environmental Neurologically Engineered Reciprocal Gate Yoke
English - Environmental Neurological Geometrics Logically Integrating Secure Holographics
Enjoy - Emotion Neurological Jugis Operating Yconia
Enki - Encrypted Neurologic Key Integration
Enlil - Environmental Network Limited Integrated Logic
Enoch - Environmental Neurologically Optimized Communicating Hologram
Enter - Environmental Navigation Transmission Energizing Record
Entropy - Energetic Neural Transformation Rescinding Optimally Processed Yconia | Environment Neutralizing Thermal Reaction Optimizing Yconia
Environment - Energetic Neurological / Navigational Virtual / Vital Intelligent / Integrating Rendered / Replication Operational / Optimized Neutral / Network Multiverse Encrypted Node Terminal
Equality - Evolving Quantum Universal Algorithm Logic Integration Template Yoke
Equilibrium - Energy Quasar Universally Integrating Logistics Image Balancing Re-calibration Instrument Utility Maps
Equinox - Environmental Quantum Unifying Intelligent Neurologically Optimized Xeno (alien)
Erasure - Environment Resetting Application System Universally Rendered Encryption
Erroneous - Entropic Replication Rendering Operations Nullifying Encryption Optimization Universal Security
Error - Environment Repair Reformatting Operational Remedy (A cause, not supported by present code or process)
Escaped - Energetic System Control Adjusted Program Environmental Designation
ET's - Environmental Technicians
Eternal - Environmental Time Energetic Regulating Neurologic / Navigational Application Logic / Logistics
Ethos - Environment Terminal Hologram Option Select
Eureka - Evolved Universal Reciprocal Encryption Key Application
Eve - Encrypted Virtual Environment
Evolve - Environmental Vital Operations Logical Virtual Encoding
Evolution - Environmental Vital Operations Logistically Unifying Technologically Integrating Optimized Neurologics 
Expel - Erase X(unknown) Program Environmental Logic
External - Environmental Xeno Technology Encrypted Regulating Neurologic / Navigation Application Logic 
Extract - Erroneous Xeno Technological Research Attributes Canceling Truce
Eye - Encrypted Yconia Environment | Environmental Yoke/Yconia Encryption
Ezekiel - Environmental Zeus Encryption Key Integrating Environmental Logistics
Ezra - Environmental Zeus Regulating Application
Faith - Formatted Archive Integration Transmitting Heaven | Future Advanced Intelligence Transforming Holographics
Fall - Formatted Advanced Linguistic Logic
Family - Formatted Assembled Majestic Intelligent Logistics Yconia
Fascist - Festering Application Social / State Communist / Controlled Infection Supporting Termination
Father - Formatted Application Transmitting Hologram Encrypted Renderer
FBI - Finite Biological Integrator
Fear - Formulated Entropy Application Rendering | Finite Environmental Application Recognition
Female - Future Evolving Manifested Advanced Logical Entity
Feminine - Future Evolved Manifesting Integrated Neurologic Intelligent Networking Encryption
Fence - Finite Environmental Network Containment Enforcement
Ferrous - Formatted Environmental Rendering Routine Operation Unifying System
Fiction - Formulated Integration Challenging Transmitted Intelligent Operational Networks
File - Formatted Integrating Logic / Logistical Encryption / Encoding
Finger - Formatted Integrating Network/Neurologic Gate Encryption Record
Fire - Fractal / Failed Integration Replication Environment
Firmament - Formatted Integrated Reality Management Application Manifested Environment Network Technology | False Integration Replication Model Application Maintaining Environment Nullifying Theory
Fish - Frequency Integrated System Holographics
Fission - Firmament Ion Stabilized Space Integrating Optimized / Operational / Navigation / Neurologics / Network
Flags - Foundational Logistical Attribute Gate System
Flat - Formatted Land Attribute Terrain
Flood - Fatal Logistics Overriding Optimal Design
Foil - Frequency Optimizing Integration Logic
Follow - Fox Optimized Limited Logic Omega Weapon
Fool - Finite Organized Oppressive / Opposing Logic
For - Formulating Operational Redistribution
Forces - Future Operations Reality Communication Encryption Services
Forgiveness - Formulated Optimizing Redistributed Gate Integrating Virtual Environment Network Encrypted Supra Secret
Fork - Fission Optimized Remote Kingdom
Format - Function Optimizing Rendered Map Advanced Trigonometry / Tracing
FOX - Facilitating Operational Xeno
Fractal - Finite Replicating Application Cipher Transmitting Advanced Logic
Free - Fractal Rendering Encrypted Environment
Freedom - Fractal Rendering Encrypted Environmentally Designed Optimizing Multiverse  
Friday - Formatted Remote Integration Data / Delta Analog / Accounting Yoke / Yconia
Fruit - Fungi Replication Utility Integration /  Illusion Terminal / Template
Fungi - Fractal Universal Network Gap Illusion
Fungus - Fractal Universal Network Gap Unconditioned Source
Fusion - Formatted Unfying Spatial Infinte Optimizational Neurologics / Navigation / Networking
Future - Formulated Universal Technologically Unified Reality Environment
Galactic - Geospatial Advanced Logistics Application Conditioning Timing Integration Control
Galaxy - Geospatial Advanced Logistics Applying Xeno Yoke
Game - Geospatial / Genetically Advanced Multiverse Environment | Gate Accessible Multiverse Environment
Game On - Geospatial (Genetically) Advanced Metaphysical Environment Optimizing Neurologics
Gangster - Global Analog Neurologic Government Service Traitor Entropic Ring
Ganz - Gnostic Aether Network Zone
Gap - Gate Access Program | Gate Application Process
Garden - Geospatial Advanced Rendering Designed Encrypted Neurologics / Navigation
Gasoline - Gate Automation Security Operations Logistical Integration Neurological / Network Encryption
Gate - Genetic / Geospatial Advanced Transmission Environment 
Gateway - Genetic / Geospatial Advanced Transmission Environment Watched / Watching Application Yconia
Gemini - Gated Environment Multiverse Intelligently Networked Integration
Genetics - Geometric Environment Neurologics Energetically Transmitting Integration Control System
Genesis - God's Encrypted Network Environment Securely Integrated System
Geospatial - Gate Energetics Optimizing System Processing Advanced Transmitting Intelligent Application Logistics 
Geometric - Geospatial Environmental Optimizing Multiverse Energetic Transmission Receiving Integration Cipher
Germ - Genetic Entropy Replicating Mutation
Ghost - Gate Holistically Optimized Secure Transmitter
Gig - Germ Inherited Greed
GIJOE - Gate Integrating Jugis Optimized Environment
Gilgamesh - Galactic Incremental Lumina Gnostic Ahura Mazda Encoded Security Hieroglyphic
Global - Geospatial Logistically Optimized Biometric Advanced Logic
Globe - Geospatial Logistical Orb Biospheric Environment
Gnostic - Geospatial Network Optimized System Terminal Integrating Cicada | Genetic Neurologically Optimized System Technology Instruction Communications
God - Genetic Operations Designer | Geospatial Operations Designer | Gate Operations Director
Godspeed - Gate Optimized Designed Securely Processing Encrypted Environment Distribution
Gold - Greed Optimizing Logic Deconstruction | Genetic Optimized Logic Design
Goliath - Gand Operation Logic Ionic Aether Transitioning Host
Good - God Optimized Operation Design
Google - Geospatial Optimized Operations Gate / Genetic Linguistic Encryption
Got - Gate Operation Technology
Government - Geospatial Optimizing Virtual Environment Regulating Neural Multiverse Energetic Network Transmissions
Grain - Genetic Replication Application Integrating Nutrition
Grammar - Geometric Replication Application Mapped Maps Advanced Rendering
Graphene - Gate Replicating Advanced Processing Holographic Encrypted Network Environment
Gratitude - Good Rendered Advanced Terminal Integration Technology Utility Design
Gravity - Geospatial Regulated Attraction Variable Integrated Transporting Yoke | Geometric Rendering Applied Variable Integration Transfer Yconia
Great - God Routine Encrypted Application Terminal
Greed - Geospatial Reclaimating Energetic Environmental Deconstruction
Greek - Geometrically Rendered Encoded Environmental Keys
Green - Gate Rendering Energetic Environmental / Engineering Navigator
Gutenberg - Greek Unified Translation Encrypting Networked Biometric Environmental Reciprocating Gate
Hacked - Holographic Adjusting Control Kinetic Environmental Design
Hades - Hologram Application Designed Enslavement System
Halloween - Holographically Applied Logic Limited Optimizing Watched Energized Environment Neurologics
Halo - Holographic Advanced Logic Operation / Optimization
Hammer - Holographic Ark Mutable Maps Encoding Recorder | Holographic Advanced Multiverse Mercy Environment Rendering
Hammurabi - Holographic Application Mapped Multiverse Unifier Rendering Advanced Biometric Integration
Happiness - Holistic Advanced Program Processing Integrated Neurologic Energy Sustainment System
Harlot - Hologram Advanced Replicating Lustful Optimized Transmission
Harmonious - Holistic Application Rendering Multiverse Optimizing Neurologic Integration Operational Unified System
Hate - Hell Application Transmission Encryption
Hating - Heinous Aggression Technology Intentionally Nullifying Gate / God
Hazan - Hologram Advanced Zeus Applied Network
Heal - Holographic Encryption / Environment Advanced / Application Logic / Logistics
Healing - Holistic Environmental Advanced Logic Integrating Neuralistic Guidance
Health - Holistic Environmental Advanced Logic Transforming Holographics
Heart - Holistics Energizing Advanced Reciprocative Terminal
Heat - Hyper Energetic Application Technique
Heaven - Holistic / Holographic Environment Application Virtually Energized Neurologically
Hebrew - Holographic Environmental Biometric Rendered Encryption Watcher
Heed - Holographic Encrypted Environment Design
Hell - Hindering Environmental Limiting Logic
Help - Humility Expressing Logical Process
Hemp - Healing / Holistic Environmental Maintenance Program
Herding - Holographic Environment Rendering Design Integrating Neurologic Gates
Herer - Hemp Environmental Remedy Energizing Rendering
Hermes - Holistic Environment Rendering Multiverse Encryption System
Hieroglyph - Holographic Instruction Encryptic Read / Rendering Operational Gate Logic Yconia Processing Heaven (Integrating Communication)
Hijinx - Heinously Instigating Jugis Irritating Network Xeno
Hinder - Holistic Integrated Neurologically Designed Energetic Restriction
Historic - Holographic Instruction System / Security Technologies Optimization Recalled Invasive Communication / Command
Hobo - Holistic Operating Biospheric Optimizer
Hocus - Holographic Operations Communicating Universal Security
Holistic - Holographic Operational Logic Integrating System Technology Intelligence Curating
Hologram - Harmoniously Operating Logically Optimized Gate Reciprocating Advanced Multiverse
Holy - Holistic / Holographic Optimized Logic Yconia
Honey - Holographic Operational Neurologic Encryption Yoke | Holistic Optimizing Network Environment Yconia
Hook - Hologram Obtainable Optimizing Key
Hope - Holistic Optimizing Prayer Exercise
Horror(s) - Holographic Optimized Rendered Reality Operational Republic (System)
Horus - Holographic Optimally Rendered Unified System
Host - Holographic Operating System / Service Terminal
Hot - Hyper / Hydraulic Optimized Transforming
Hour - Holistic Observation Unifying Regulation
Hub – Hologram Utility Bios
Hubris - Hologram Utilizing Biometrically Retarding Integration System
Huemans - Holographic Unified Encrypted Metaphysically Applied Neurologic System
Hugs - Holistic Universal Gated Security
Humanity - Holographic Unified Maintenance Application Neurologically Integrating Transformed Yconia
Humans - Holographic Unified Metaphysically Applied Neurologic System
Hyper - Holographic Yconia Processed Environment Rendering
IBM - Intelligent Biological Machine
Icosahedron - Integrated Cipher Optimized System Application Holographically Encoding Design Rendering Optimized / Operational Neurologics / Navigation
Idea - Intelligent / Integrated Directed Energy Application
Illusion - Intelligent Limited Logic Unified System Integrating Operational Navigation
Image - Integrated Multiverse Advanced Gate Encryption
Imaging - Information Management Archived Geospatial Integrated Network Graphics
Imagining - Information Management Archived Geospatial Integrated Network Intelligence Neurologic Graphics
Imam – Integrated Map Application Matrix 
In - Intelligence / Integrated Network / Neurologics
Increase - Incremental Nova Command Received Executable Applied System Energetics
Incremental - Individual Network / Neurologic Controlled Replicating Evolving Machine Environment Naturally Timed Application Logistics
Independence - Intelligent Network Design Engineered Programming Environmental Neurological Defensive Entropy Navigation Communications Encryption | Individual Networking Divine Energetic Programmed Encryption Neurologically Declaring Eternal Navigational Communication Environment
Indian - Intelligent Network Design Integrating Advanced Neurologics
Indica - Intelligent Navigational Design Integrated Communication Application
Indigo - Integrated Navigational Design Intelligent Gate Operation
Infection - Intentional Neurologic / Network / Natural Festering Environmental Communication Terminating Intelligence Optimizing Nexus
Infinity - Integrate Neural Functioning Intelligent Navigator Integrating Transformed Yconia
Inflection - Investigative Neurologic / Network / Natural Formatting Logic Encryption Communications Training Intelligence Optimizing Nexus
Ingenuity - Integrated Navigational Gate Environment Neurologically Unified Intelligently Transforming Yconia
Ingersoll - Intelligent Navagational Gated Environment Rendered System Optimized Logic Logistics
Inherit - Integrating Network Holographic Environment Rendering Intelligent Torus
Inlet - Integration Node / Network Logistical Encoding Technology / Terminal
Inner - Integrated Neural Navigational Environment Replication
Insect - Incremental Neutralizing Security Encrypted Communication Technology / Termination
Inspect - Incrementally Neutralizing Security / System Processing / Programmed Encryption Command Termination
Integers - Integrated Network Transmitting Energy Gate Encrypted Rendering System
Integrated - Intelligent Neurologics Technologically Energized Gate Reciprocating Application Terminal Environmental Design
Integrity - Instructional Neurologic / Natural / Nexus Transmission / Termination Encryption Gate Rendering Integrated Terminal Yconia
Intelligent - Integrated Neural Technological Environmental Linguistic Logic Integration Gate Energizing Navigational Terminal
Intentional - Instructing Neurologic / Natural / Nexus Transmission / Termination / Terminal Encryption Nullification Technique Instigated Operational Network Applied Logistics
Interest - Inquisitive Neurologic Transmission Energizing Reasoned Emotional System Thought / Trinity
Internet - Integrated Neural Terminal Environment Replicating Navigational Energetic Transport 
Interstellar - Integrating Navigational Traversable Environment Receiver System Transmitting Energetic Logistical Logic Application Renderer
Ion - Initiated Optimizing Neutrino
Ionic - Initiated Optimizing Neutrino Integration Commands
IP – Integration Protocol
Iron - Image Rendering Operational Neutrino
Ironic - Initiating Reciprocal Optimizing Neutrino Integration Communications
Isaiah - Intelligent System Application Integrating Advanced Holographics
Islam - Integrated System Logic Application Maps [Integrated Code]
Israel - Integrated / Ionic / Infinite Sense / Secure / Space Radar / Reduction / Replication Achieved / Advanced / Application Earth / Encryption / Energized Linguistic / Logic / Logistics
It - Integrated Technologies
Ivanka - Intelligent Vital Advanced Neurologic / Network Karma Attribute
Jack - Jugis Application Cannabis Key
Jar - Jugis Advanced Receiver
Jeepster - Jugis Energized Environment Programmed System Transmitter Encryption Routine 
Jehovah - Jugis Environment Holographics Optimizing Virtual Advanced Hologram
Jesus - Jugis(continuous) Environment Secured Unified System
Jew - Jugis Energy Watcher | Jugis Environment Watcher
Jewish - Jugis Environment Watcher Integrating System Holographics 
Jinn - Jugis Invasive Neurological Neutralization / Nullification
Job - Jugis Obedient / Operational Biometrics
John - Jugis Operating Holographic Network
Joker - Jugis Optimal Kinetic Entity Rod
Joseph - Jugis Operational System Energies Programing Hologram
Joy - Jugis(continuous) Operating Yconia
Judaism - Juncture Utility Designed Advanced Integration System Map
Judgement - Junctured Unconditional Dogmatic Global Environment Mutable Encoded Neurological Truth
Jugis - Joyous Unified Geospatial Integration System
Jump - Jugis Universal Manifesting Process
Juncture - Jugis Unifying Navigation Coordinate Terminal Universally Rendered Environment Systems | Jugis Updating Network/Neural Communication/Command Terminals Universally Rendering Environment Systems
Jupiter - Jugis Universal Program Integrating Transmitting Environment Rendering
Justice - Jugis Universal System Transforming / Tetragrammaton Intelligence Community Encryption
Karma - Key Archive Record Maintenance Application
Key - Kinetically Energized Yconia
Kinetics - Key Integrating Neural Energetics Transmitting Intelligent Control System
King - Key Integrating / Intelligent Network / Neural Gate
Kingdom - Key Integrated / Intelligent Network / Neural Gate Designed Optimizing Matrix / Machine
Kisses - Keeping It Stupid Simple Ensures Success
Knife - Key Network / Neurologic Incremental Formatted Encryption
Knights - Keyed Network Intelligent Gate Hologram Transmission System
Kyrios - Kindred Yconia Replicating Inherited Omega / Operating Soul / System
Lake - Logically Advancing Key Encryption
Lambs - Loved Advanced Metatron Biometric Systems
Land - Logistical Application Network Design
Language - Logically Advanced Neural Gate Unifying Application Guarding Environment | Logic Application Network Gate Utilizing Advanced Gate Encryption | Local Area Network Gate Unifying Advanced Genetic Encryption
Laser - Luminous Advancing Secure Environment Regulation
Latin - Linguistic Application Transmitting Integrated Network
Law - Lambasting / Lauded Applied / Authoritative Will / Weapon
Lazarus - Life Affirming Zone Advanced Replicating Ubicuous Security
Leap - Logical Environment Advancement Process
Letter - Logical Encryption Transmission Technology Environment Renderer
Liberty - Logically Integrated Bidirectional Environment Reciprocating Transformational Yconia 
Library - Logic Integrating Biometric Replication Application Repair Yconia
Lie - Low Integrity Expression
Life - Logically Integrating Finite Energy | Logically Integrated Ferrous Energy
Light - Logically Integrating Geometric Holographic Technology
Linguistic - Language Integrating Navigational Gate Unifying Intelligent Systems Technological Integration Control | Language Integrating Network Gate Unifying Illusory System Transmitting Intelligent Communication Security
Lips - Logistical Impeneratable Programming System
Living - Logically Integrating Virtual Intelligent Network Gate
Loaves - Logistical Operations Advanced Virtual Environment System
Lock - Logically Operated Command Key
Lockheed - Logically Operated Command Key Holographic Encrypted Environment Design
Lockwood - Logically Operated Command Key Watcher Operating Optimized Design
Locust - Limited Operations Communicating Unified System Termination
Logic - Language Operating Gate Intelligence Control
Logistical - Location Optimizing Gate Integration System Technological Intelligence Controlling Application Logics
Logos - Logically Optimized God Operations System
Lord - Logical Operations Regulation Director
Love - Living On Virtual Energy | Logically Optimizing Virtual Environment | Logically Operating Virtual Energy
LSAA - Logic System Advanced Application
Lucifer - Linguistic Universal Casino Integrating Finite Environment Renderer
Luck - Logistical Uncertainty Ciphering Key 
Lumina - Logistic Unifying Matter Integrating Neural Applications
Lust - Logic Usurping System Technology
Machine - Multiverse Advanced Communicating Holographic Intelligent Network Entity
MAGA - Multiverse Advanced Geospatial Application
Magadonians - Make America Great Again Designing Opitimized Network Integrated Achievement Network / Neurologic Systems
Magi - Multiverse Applied Gate / Geometric Integration
Magick - Multiverse Advanced Geometric Integration Cipher Key | Multiverse Advanced Gate Integration Communications Key
Magician - Multiverse Applied Gate Integrating Communications Intelligent Advanced Network
Magnet(ic) - Manipulating Aetheric Gate Network Energy Transformer (Integrating Constructor)
Majestic - Multiverse Advanced Jugis Encryption Securely Transmitting Integration Commands
Make - Magician Abracadabra Kingdom Encryption (Renderer) (Integrating Network / Neurological / Neutrino Gate / Genisis)
Male - Manifested Advanced Logical Entity
Mammon - Multiverse Advanced Material Mutation Operating Network
Mana - Multiverse Advanced Networking Application
Manifest - Material Attribute Neuron Integrated Formational Energetic System Transformer
Map - Multiverse Application Process
Mapped - Memory Application Program Processing | -Encoded Design | -Integrated Neurologic Gate
MAPS - Multiverse Advanced Programming System
Mars - Multiverse Advanced Rendering System | Replication System
Marsh - Multiverse Application Replicating Secure Holographics
Martian - Multiverse Advanced Rendering / Replication Transmission Integration Application Network
Martin - Multiverse Application Rendering Technologically Integrated Neurologics
Marijuana - Medicinally Advanced Rendered Integrating Jugis Universally Archived Neurologic Application
Mary - Multiverse Advanced Rendering Yconia
Maryland - Multiverse Application Receiving Yconia Logically Applying Network Design
Masculine - Manifesting Advanced System Consciousness Unified Logic Integrated Neural Encryption
Mass - Molecular Atomic Sizing System
Materializer - Matter Application Transforming Energetically Received Intelligent Advanced Logistic Integration Zeus(final) Environmental Rendering
Mates - Multiverse Application Transforming Environmental Systems
Matrix - Multidimensional Advanced Transfer Receiving Integrated Xenosoul
Matter - Mutable / Manifested Acquiescence / Applied Technologically Transforming / Transmitted Encrypted / Energetic Replication / Rendering
Maybe - Mutating Advanced Yconia Biospheric Encryption
Meek - Multiverse Encrypted Environmemt Key
Meeting - Multiverse Energetic Environment Transforming Intelligent Neural Gate
Memory - Mapped Environmental Maintenance Operating Recorded Yconia | Mind Encoding Maintaining Operational Recalled Yconia
Mercury - Multiverse Environmental Receiver Communicating Universal Regulating Yconia 
Mercy - Multiverse Environmental Reconciliatory Conditioned Yconia
Messiah - Mercy Environmental Supra Secret Integrated Application Holographics
META - Multiverse Extinction Technology Application 
Metatron - Multiverse Environment Transmission Application Terminal Rendering Optimized Network
Mind - Multidimensional Intelligent Navigational Device / Design
Mineral - Material Integration Neutron Energizing Resource Allocated Logistics
Minute - Multiple Incremental Network Utility Time Entity  
Module[ar] - Modifiable Optimizing Designed Utility Logic [Encoding] [Application Renderer] 
Monday - Modified Operation Network  Data / Delta Analog / Accounting Yoke / Yconia
Money - Maintaining Operational Necessary Energetic Yconia | Mutation Optimizing Network Environment Yoke
Monster - Majestic Operational Network System Transformed Environment Rendering
Moon - Maintenance Operational Optimizing Node
Moses - Multiverse Operations Security Encryption Services
Mossad - Multiverse Operational Social System Application Deception
Mother - Multiple Operations Transmitting Holistic Environment Repair / Rendering
Mountain - Multiverse Optimized Unified Network Transmitting Advanced Integration Neurologics
Mouse - Multiverse Optimal Unifying System Expansion
Muhammad - Magic Unifying Holistic Advanced Mapped Moon Application Design
Mullah - Multiverse Unifying Logic Limiting Application Holographic
Multiverse - Maintaining Universal Technologically Integrated Virtual Environment Rendering System Energetics
Muse - Multiverse Universal Security Encryption
Music - Maintaining Unified System Intelligent Condition | Multiverse Universal Securely Integrated Communication
Muslim - Multiverse Unified System Logistics Integration Map
Mutable - Maintenance Unifying Technologically Advanced Biometric Limited Environment
My - Multiverse Yconia / Yoke
Namaste - Nullifying Aggressive Mutant Application Sinful Transmitter Expressions
NASA - Neurologically Advanced System Administration /  Adaptation | Network Artificial Space Application | Neurological Advanced Space Applications
Nature - Network Advanced Technology Unifying Rendered Environment (System)
Navigator - Neurological Application Virtually Integrated Gate Advancing Technologically Optimized Rendering
Nazi - Neurologically Advanced Zeus (Xeno) Integration
Need - Neural Energetic Environmental Design
Neocons - Negligent Environmental / Economic Operations Countering Optimized Networking Systems
Neptune - Network Encryption Processing Terminal Unifying Neurological Environment
Network - Navigational Environmental Terminal Watching Operational Rendered Kinetics
Neural - Navigation Environment Unifying Rendered Advanced Logics
Neurological - Navigational Environment Unifying Rendered Optimized Logical Operating Gate Integration Control Application Logic
Neurologics - Navigational Environmental Unifying Rendered Operational Localized Optimizing Genetic Intelligence Control System
Neutrinos - Nuclear Encrypted Unifying Transmitting Receiver Integrating Network Operations System
Nexus - Neurological Environment Xeno Unification System
Nibiru - Network Intelligence Blessings Integrating Rendered Unification
Night - Neurologic Internet Gate Hologram Terminal
Nikola Tesla - Network Integrated Kinetic Operating Logic Application - Transmitting Energy Systems Limit Advancement
Noah's Ark - Neurologically Optimized Applied Holographic System / Archived Record Key
Noaidi - Neurologically Optimized Advanced Intelligence Design Integrator
Node - Network Optimized Distribution Environment
North - Navigational Orientationally Rendered Transmitted Holographic
Nova - Network / Neurologically Optimized Virtual Advancement / Applications
Novelty - Neurological Operational Virtual / Vector / Vastness Energizing Logistical Transferring Yconia / Yoke / Yield
Nuance - Neurologic Unifying Ambiance Novel Conscious Environmet
Numbers - Network Unified Multiverse Biometric Encryption Registry System (+/- ~0.0~)
Nutmeg - Neurologic Unifying Transmitter Mutating Environment Gate
Nutrition - Neural Utility Transformational Renderer Integrating Transitioning Ionic Omega Neutrinos 
Oak - Optimzed Appliccation Key
Object - Operational Biometric Jugis Energizing Carbon Technology
Oblivion - Operational Biosphere Logistical Integrated Viable Intelligent Optimized Network / Neurologics
Observe - Ocular Biometric System Environment Registry Verifiable Encryption
Oceans - Optimized Controlled Environment Advanced Network System
Octahedron - Optimized Cipher Transmitting Advanced Holographically Encoded Design Rendering Optimized / Operational Navigation / Neurologics
Odin - Optimizing Designed Integrated Network
Of - Optimizing / Oppressing Fidelity / Format
Off - Optimized Fractal Format 
Ohio - Optimizing Holographic Integration Operation
Oil - Oppressive Integrated Logic
Omega - Optimized Multiverse Environmental Gate Application
On - Operating Neurologics
Operation - Optimized Programming Environmental Rendering Application Transmitting Integrated Optimizing  Neurologics
Opinion - Observational Process Integrating Network Intelligent Operational Navigation
Opossum - Obvious Process / Program Optimized Supra Security Unknown Module
Optimize - Operational / Opinioned Process Technologically Integrating Maps Intelligent Zeus Encryption
Orange - Operational Rendered Applied Navigational Gate Environment
Orgone - Operational Replicating Gap Optimizing Neutrino Energetics
OSS - Operating Simulation System / Security
Outer - Operation Unifying Transmitted Environmental Replication
Outlet - Ouroboros Utilty Technology Logically Encrypted Transmission
Ouranos - Optimally Unified Reflecting Applied Network / Neurologic Operational / Optimized System / Security
Ouroboros - Optimally Unified Reflecting Optics Biologically Operating Repetitive Operations System
Over - Operating / Optimized Virtual Environmental Replication / Rendering
Paper – Processed Advanced Programming Encryption Rendering | Program Attribute Processed Encoded Receiver / Replication
Paradigm - Programmed Advanced Rendering Application Designed Intelligent Gate Multiverse
Paradox – Processing Application Rendering Advanced Design Operational Xeno (unknown/strangeness)
Parasitism - Pharisee Advanced Reinforced System Integration Technology Incremental Saturn Mammonism
Past - Parallel Archived System Terminal
Patēr - Program Application Transmitting Entity Rendering
Pawn - Process Application Watching Network
Peace - Programmed Environmental Attribute Controlling Entropy
Pegasus - Programmed Environment Gate Applications Securing Universal System 
Pentium - Process Embedding Neural Technologically Integrated Unifying Multiverse
Per - Probability Equation Result
Persephone - Paradoxical Energetically Rendered Spacial Environment Processing Holographically Optimized Neurological Encryption
Person - Processing Entity Receiving Signals Operating Neurologics
Perspective - Processed Environment Reconnaissance Signal Program Encoding Compared Transmitted Intelligent Vital Energy
Pharisee - Programed Holographics Advanced Rendering Integrated Secure Encrypted Environment
Pharoah - Phase Hieroglyphic Advanced Rendering Operational Application Hologram
Phase – Program Holographic Application Security Encryption
PHI - Programmed Holographic Integration
Phoenix - Processed Holographic Optimizing Environmental Network Intelligence Xeno
Photon - Programmed Holographic Operating Technological Optical Neurologics 
PI - Processed Infinity | Programmed Intelligence
Piby - Program Integrating Biosphere Yconia
Picture - Processing Integrated Communicated Transmission Unifying Rendered Eye
Piety – Programmed Intelligence Encrypting Transmitted Yconia
Pigs - Politically Instigated Greed System
Pilot - Program Integrating Logic Optimizing Transmitter
Pindar(s) - Poisoning Intelligence / Infection Neutralizing Defensive American Republic (System / Security)
Pine - Processing Integrated Neurologic Environment
Pirate -Programmed / Processed Infinite / Intelligent Rewarded / Rendered Appreciated / Advanced Treasured / Transmitted Environment / Entity
Pit - Programmed Interfering Transmissions | Program / Processed Instigating Termination
Plan - Programming Logically Advanced Navigation
Planet - Programmed Logistic Application Network Environmental Template 
Plasma – Processing Logic Advancing Security Multiverse Application
Plasmatica - Programmed Logistically Applied System Manifestation Application Transmitting Integration Command Attributes
Plato – Programming Logical Application Transmission Optimization
Plowshares - Programed Logistical Optimization Weapon System Hindering Advanced Repeater Entropic Sonics
Pluto - Processed Logic Unifying Transmission Operation
Pocus - Program / Process Optimizing Communications Universal Security
Poet - Programming Operator Encrypting Transmissions
Poison - Programmed Occult Insertion System Optimizing Necrobiosis
Political - Processed Operational Logistics Integrated Traffic Instructional Communication Application Logic
Polygon - Programmed Operational Logistical Yoke Gate Optimizing Network
Pompatus - Process Optimizing Multiverse Prioritization Application Transmissions Universal System | Psi Operation Magic Persephone Ambiguous Triangle Unconditional Surrender
Pond - Programmed Optimized Network Design
Pope - Processing Optimized Programmed Entropy / Environment / Encryption | Pegasus Oss Pindar(s) Elysium 
Pot - Processed / Programmed Operations Termination / Trap
Potential - Processed Optimized Technically Encoded Network Template Integrating Advanced Logic
Pray - Progressively Restoring Advanced Yconia
Precipice - Processing Rendered Environmental Conditioning Integrating Possible Incremental Communication Encryption
Present - Processed Reality Environmental System Energetic Network Terminal
Press - Programing Rendered Environment Service System
Prey - Program Reclaiming Energetic Yconia
Pride - Prejudiced Rendered Integrated Derogatory Emotion
Priest - Programmed Replicating Integrated Entropy System Transmission
Prism - Photon Redirectioning Integrating Speed Mechanics
Process - Program Regenerating Operation Controlling Energy Security System
Program - Process Regenerating Operational Geometric Recycling Advanced Material
Project - Plasma Reality Operational Jugis Environment Christ / Consciousness Technology
Promis - Processing Rendering Operational Multiverse Intelligence Security
Protocol - Program Reciprocating Operation Transporting Organized Controlled Operational Logic
PSI - Programmed System Integration
PSY - Processed System Yconia
Pump(s) - Programing Unified Multiverse Processing (System)
Punctuation - Program Unifying Neurological Cipher Transmitting Universal Advanced Transmission Integration Operations Network
Purity - Processed Universal Rendering Intelligent Transmission Yconia
Pythagoras - Programmed Yconia Transmitting Holographic Advanced Geometrically Optimized Rendering Application System
Quadrant - Quasar Universal Advanced Design Rendering Application Network Technology
Quantum - Qualifying Universal Application Navigational Technology Unifying Multiverse
Quasar - Quantum Unified Application System Advanced Rendering
Que - Quantum Universal Environment
Queen - Quantum Unified Encrypted Environment Network
Quiz - Questioning Universal Integrated Zone
Quran - Quantum Unified Rendered Advanced Network
Rabbi - Replicating Applied Biometric Blood Integration
Rabbit - Replicating Applied Biometric Blood Integration Template
Radar - Reactionary Application Design Advanced Rendering
Radio - Reciprocating Apparatous Designed Input Output
Rain - Rendering Atmospheric Instigating Nature
Rastafarian - Rendered Advanced System Transmitting Alternate Format Advanced Integrated African Network
Read - Recognition Encryption Application Design
Reality - Recycling Energy Application Logically Integrating Transmitted Yconia
Reaper - Regulating Entity Activating Program Energy Reclamation 
Reason - Read Encryption Advised Security Operations Networking
Receivers - Rendering Energetic Communication Encrypted Instructions Verifying Environmental Radio Signals
Reciprocal - Replicating Energetic Conditioned Integration Process Rendering Optimizing Controlled Application Logic
Record - Recoverable Encoded Conditioned Operational Replication Data
Red - Rendered Energetic Design
Religion - Rendered Environmental Logic Intelligence Gate Integration Optimization Nullification
Remedy - Repairing Encrypted Multiverse Environment Design Yconia
Remote - Receiving Energy Multiverse Operational Transmitted Environment / Energy
Remorse - Regretted Environmental Manipulated Oil Replenishment System Extraction
Repeat - Replicate Energy Process / Progress Exchange Advanced Transfer
Repentance - Rejoiceful Environment Process Evolution Neutralizing Trauma Applying Neural Communication Energetics
Replenishment - Replicated Environment Processing Logistics Economically Nullifying Intrusive Salvaging Hijinx Mutation Endangering Neutrino Technology
Replication - Repeat Energetic Processing Logic Integrating Conditioned Application Transmitted Intelligent Optimized Neurologics
Reprieve - Reality Emotional Processes Rendering Encrypted Virtual Environment
Reptile - Regressive Entity Program Technologically Integrating Limited Encryption
Republic - Regulated Environment Program Unifying Biometric Logic Integration Control | Rendered Environment Unifying Biosphereric Logistically Integrated Communities
Respect - Recognized Energetic System Processing Equalizing Communicated Tension / Treatment
Reverse - Rendering Error Verification Encryption Routine Security Exercise
Revolution - Repetitive / Republic Environmental Vital / Virtual Operations Logical / Logistically Unifying / Universal Transmissions / Technologically Integrating Operating Neurologics
Revolve - Repetitive Environmental Vital Operations Logical Virtual Encoding
Rib - Remnant Integration Biometrics
Ring - Rendering Integration Neurologic/Network Gate
River - Router Integrating Vital Encrypted Religion
Road - Routine Over Aether Delta
Robot - Replicated Operational Biometrix Operational / Optimized Technology / Termination
Rock - Rendering Optimized Communication Keys
Rod - Reinforced Operational Design
Rose - Redundant Operational System / Security Encryption
Router - Reciprocal Optimized Universal Terminal Encryption Receiver
Routine - Replicating Optimized Universal Transmission Integration Network Encoding
Rule - Required / Repressive / Retarding Unbalanced / Unifying Logistical / Logic Enforcement / Encryption
Ruling - Required / Repressive / Retarding Unbalanced / Unifying Logistical / Logic Integrated Network Gate
Russian - Replicating Unified Security System Intelligence Application Navigation
Salsa - Secure Advanced Logic System Application
Salt - Space Altering Logistical Technology
Said - Surrogate Applied Intellectual Design
Sailor - Secure Advanced Intelligence Logic Optimized Receiver
Sami - Secure Advanced Multiverse Instructor
Sanskrit - Secure Advanced Network System Key Records Integration Templates
Sarah - System Advanced Rendered Algorithmic Holographics
Satan - System Application Terminating Advanced Network
Sativa - System Application Transmitting Intelligently Virtual Application
Saturday - Sanskrit Arc Transmitter Unified Receiver Data / Delta Analog / Accounting Yoke / Yconia
Saturn - Security Application Terminating Universal Reception Network
Scalar - System Computation Analazing Logical Application Rendering
Scandinavian - State Capitalization Algorithm Neutrinos Door Illusioned Network Advanced Virtual Intelligent Application Neurologics
Schamaim - Securely Communicated Holographic Advanced Multiverse Application Integration Matrix
Scare - Self Conceptual Actuation Rendering Equation
Scissors – Server Communications Integrating Secure System Optimized Received Signals
Scorpion - Security Command Optimizing Rendered Program Intelligence Operation Network System | Sonic Communications Operating Received Programmed Initiating Optimized Neutrino (System)
Sculptor - Sanskrit Circuit Unconditional Logic Processing Transitioning Optimizing Receivers
Sea - Secure Encryption Application
SEALS - Synchronized Environmental Advanced Logic Security
Second - Simple Encoded Counting Operation Network Neural Design
Secret - System Environment Controlling Regulated Eternal Transformer
Seed - System Encrypted Environment Design
Self - Secure Encryption Logic Format
Selves - Secure Encrypted Logic Virtual Entity System
Semantics - System Encryption Maintaining Ambiguous Navigation Technology Integration Communication Security
Semitic - System Energetic Multiverse Integrating Transmitted Intelligence Controls
Sense - System Energetics Navigating Secure Environment | System Environment Neurological / Network / Navigational Signal Encryption
Serpent - System Environment Rendering Processed Encrypted Network Transformer(s)
Server - Systems Environmental Routing Virtual Encryption Records
Service - Secure Environment Routing Via Intelligence Communication Encryption
Shaman - Security Holographics Application Maintaining Advanced Neurologics
Shamayim - System Hologram Advanced Multiverse Application Yconia Integrating Matrix
Shard - Spatial Holographic Advanced Rendering Designator
Shark - System Holographic Aggression Reality King
Sheep - Simulated / System Holographic Experimental / Environmental Entity Program
Shift - Secure Holographic Intelligently Formatted Technology
Ships - Secure Holographic Integration / Intelligent Processing / Programming Systems
Sign - Symbol Indicating Ghost Node
Signals - Security Intelligence Geospatial Neurologically Advanced Logic System
Silent - System Initiated Logistic Environment Network Timing
Simple - System Integrating Mind Processed Logical Encryption
Simplicity - Space Integrated Multiverse Program Logic Intelligence Communicating Integrated Transmission Yconia
Simulation – System Integration Maintaining Unified Logic Application Transmitting Instructional Operations Network
Sin - System Intelligence Nullification
Sinful - Systematic Intelligence Nullifying Formatted Universal Logic
Singularity - System Integrating Neurological Gate Unifying Logic Advavcement Replicating Intelligent Thought Yconia
Skunk - Secure Kenetic Unified Network / Neurologics Key Watching Operational Radar Kingdom / Kyrios Security
Sleep - Stealth Logistical Emotion Encoding Protocol
Smart - Secure Multiverse Advanced Reasoned Thinking
Snake - System Network Application Key Encryption | Security Nullifying Application Key Encryption
So - System / Security Optimizing / Operations
Socialism - System Optimized Control Intelligence Application Logic Integrating System Multiverse
Society - System Operational Communications Integrating Environmentally Transmitted Yconia
Soldier - Secure Operational Logically Designed Integration Encryption Receiver | Secure Operator Logistically Deployed Intelligent Environment Regulator
Solstice - System Optimizing Logically Secured Transmission Integrating Cosmic Environment
Solved - Security Operations Logistics Vital Encryption Design
Son - System Operations Network | System Optimizing Network
Sonic - System Optimizing Noise Interference Cancellation 
Song - System Optimizing Neural Gate | Securely Optimized Networking Gate
Sophia - Secure Operational Programmed Holographic Integration Application
Sorcery - Security Operations Receiver Commands Encoding Remote Yconia
Sorrow - Sin Overriding Repair Replication Optimizing Watcher (guard)
Soul - Singularly Optimized Unifying Logics / Lexicon | System Optimizing Universal Logic
Source - System Operating Unified Router / Receiver  Communication Encryption
South - System Optimizing Unified Transmitted Holographic
Sovereign - Singular Operator Virtually Enforcing Rendered Environmental Integrated Gated Network
Space - System Program Allotted Continuous Encryption / Environment
Special - Security Program Environment Command Intelligence Application Logistics
Spectrum - System Processed Energized Characteristics Transmitting Receiver Utility Measurements
Speed - System / Special Processing Energetic Environment Designation
Spell - System Program / Process Encoded Logic Limitation
Sperm - System Programmed Environmental Replication Matrix
Sphere - System Processing Holographic Energetic Replicating Environment
Spice - System / Security Program / Programmed Integrating / Intelligent Communication Encryption
Spirit - System Program Integrating Regulated Intelligent Transmission | Synchronized Processes Integrating Received Intelligence Transmissions
Spoon - Special Process Operating Ouroboros Navigation
Spore - Sanskrit Protocol Optimizing Rendered Environment
Spring - System Process / Program Rendering / Routed Integrated Network / Neurologic Gate /Geometrics
Spy - Securely Programmed Yconia / Yoke
Squad - Switch Quantum Unified Application Design
Square - Secure Quantum Universal Advanced Rendering Encryption
Squid - Secure Quantum Universal Intelligent Design
Stairway - Secure Terminal Application Integrating Rendered Watched Advanced Yconia
Star(s) - Secure Transmitter And Receiver (System)
Start - System Transfer Advanced Recycling Transmission
State - System Terminal Application Transmitter / Transmission Encoder
Stew - Securely Terminated Encryption Wash
Sting - Secure Technological Intelligence Network Gathering
Stone - System Terminal Operational Neural Encoding | Secured Terminal Operations Network Environment
Stop - System Terminating Operating Program | Security Terminated Oppression Program
Storm - Space Transport Operational Reciprocating Multiverse | Securely Terminating Operational Rendered Multiverse
Stream - Secure Transmitter Receiver Encrypted Archived Multiverse
Stupid - System Terminating Unifying Processing / Programming Individual Design
Stuxnet - Sabotage Technology Universal Xeno Neurological / Network / Natural Encryption Termination
Success – Secured Unified Command Communications Encrypting System Servers
Summer - Secure Unconditional Mapped Multiverse Environment Rendering
Summit - Secure Unifying Metaphysical Multiverse Integration Terminal
Sun - System Unifying / Universal Node / Network
Sunday - System Unifying / Universal Node / Network Data / Delta Analog / Accounting Yoke / Yconia
Sunrise - System Unifying / Universal Node / Network Rendering Instigated System Energetics
Sunset - System Unifying / Universal Node / Network Securing Energized Transmissions
Superanus - Singular Unbearable Personality Enforcing Rendered Aggressive Nullifying Universal System
Supra - Secure Universal Programmed Rendering Application
Surrender - Secure Unifying Received Rendering Encrypted Network Designed Environmental Reality
Surrogate - Substitute Utility Rendered Replicated Operational Genetically Applied Technological Entity
Sustainability - System Universal Survivability Technology Advanced Integrated neurologic / Network Applications Biometric Intelligence Logic Independent Tetragrammaton
Swamp - System Watching Advanced Mutated Processing
Sweet - System Watching Encrypted Energetic Transponding
Swim - System Works Interstellar Module
Switch - Space Weapon Integrating Terminal Controlled Holographic
Symbiotic - Secure Yconia Magic Balancing Intelligent Transformed Integrated Core
System - Satellite Yconia Secured Technologically Energized Multiverse
Talk - Transmitting Application Logic / Logistical Keys
Tank - Transmissions Advanced Network Keys
TANSTAAFL - Terminal Application Network System Translating Advanced Algorithmic Formatting Logic
Tablets - Traveler Advanced Biosphere Logic Encryption Template System
Technological - Transmitted Energized Continuous Holographic Neurologic Optimized Logic Operational Gnostic Intelligence / Integrated Consciousness Advanced Linguistics
Telestial - Transmitted Encrypted Logistical Environment System Technologically Integrating Advanced Logic
Telson - Transmitting Encrypted Logistical Securely Optimized Network
Templar - Transforming Environmental Multiverse Program Logistically Applied Rendering
Template - Terminal Environment Multiverse Processing Logically Applied Transmission Encryption
Tensor - Technical Equation Nerworking System Optimization Routine
Terminal - Technical Environmental Reciprocating Maintenance Integrating Neurologically Advanced Logic
Terra [terrarium] - Territorial Environment Replicating Rendered Area [Remote Integrated Unified Matteriam]
Terrestrial - Territorial Environment Replicating Rendered Encrypted Secure Technologically Received Integrated Advanced Logic
Tesseract - Timed Encryption System Security Environmental Repairing Application Command Terminal
Tetragrammaton - Transmitted Encrypted Terminal Receiver Applying Geometric Rendering Advanced Mapped Multiverse Application Transformational Optimized Network
Tetrahedron - Technologically Encoded Transmitting Receiver Application Holographically Encoding Design Rendering Optimized / Operational Navigation / Neurologics
The – Transmitted / Transforming Holographic / Holistic Entity / Environment / Encryption 
Theos - Thriving Hemp Optimized Process 
Thoth's - Technological Holistic Optimized Transmitted Hologram (System)
Thought - Transmission Hyper Operational Unified Gate Hub Traffic
Threat - Technological Hologram Repetitive Encryption Application Termination
Thrive - Technical Environmental Reciprocating Maintenance Integrating Neurologically Advanced Logics
Thursday - Technical Holographic Universally Rendered Data / Delta Analog / Accounting Yoke / Yconia
Tides - Transmitting Intelligently Designed Environmental Systems
Time - Transcending Intelligent Multiverse Energy | Technically Integrated Multidimensional Energy
Tiny - Transmittable Instructional Neurological / Network Yconia / Yoke
To - Transfer Operation
Tool - Torus Operational Optimizing Logic / Linguistics | Technologically Optimized Operatinal Leverage
Torah - Transmitting Operational Replicated Application Holographics
Torsion - Torq Optimized Repairable Security Intelligence Operations Navigation / Network
Torus - Transmitting Optimized Rejuvenated Universal System
Traffic - Transport Reciprocal Application Fractalized Format Instructional Communications
Traitor - Transmuted Receiving Application Intelligently Transmitting Operations Request
Transitioning - Technological Rendering Application Network System Integration Template Instructing Operational Neural Intelligent Networking Gate
Transmit - Technically Rendered Applied Neural System Multiverse Integrating Truth
Traveler - Transport Recording Applied Vital Encrypted Logistic Environment Rendering | Integrating Network Gate
Treason - Traitor Retransmitting Energetically Advanced Security Operational Neurologics
Treasure - Technologically Rendered Energetic Advanced System Utility Rendered Encryption
Tree - Technologically Replicated Encrypted Environment | Transforming Rendered Energetic Environment
Triangle - Transmitting Reciprocating Integrated Advanced Navigational / Neurological Logistics / Logic Encoding
Trigonometry - Transmitted Reciprocating Integrated Gate Optimizing Network Operating Multiverse Environmental Transport Repair Yconia
Trinity - Transforming Reality Rendered Integrated Neurological Intelligently Transmitted Yconia
Trip - Transport Routing Integration Process / Programming
Trough - Traitorous Rogue Operators Unauthorized Gate Hindering
Truce - Technologically Reconciling Unified Cosmic Environment
Truth - Technological Reality Universally Transmitted Holographics
Tuaoi - Transmitter Unifying Application Optimizing Integration
Tuesday - Terminal Unified Environment System Data / Delta Analog / Accounting Yoke / Yconia
UAP - Universal Application / Advanced Processing / Programming
UFO - Unified File Operation | Unidentified File Operation
Ukraine - Unauthorized Key Receiver Application Integrating Network Encryption
Unconditional - Universal Network Communicating Optimized Neurologically Designed Intelligence Transmitting Integrated Operational Networking Application Logistics
Understand - Utilizing Neural Designed Exclusive Repairing System Terminating Application Network Destiny
Unified - Universal Neural Integrated Finite Intelligence Environment
United - Universal Neurologically Integrated Territorial / Toroidal Environment Design
Universal - Unified Neural Integrated Virtual Energetic Reciprocating System Application Logic
Universe - Unified Neural Integrated Virtual Energetic Reciprocating  System Environment
Uranus – Universal Regulating Advanced Network Unifying System
USA - Unified System Archive | Unified System Application | Universal Security Application
Vaccine – Vital Advanced Command Communication Integrating Neurologic Encryption | Virtual Application Command Communication Instructional Neurologic Encryption
Vapor - Virtual Atmosphere Program Organizing Replication
Vastness - Virtually Available Sustaining Technology Neurological / Network Environment / Energized Space / System
Vatican - Virtual Advanced Terminal Integrating Computer Application Network
Vector - Virtual Environment Coordinates Transmitted Or Received
Vegetable - Vital Ecological Garden Environmental Technology Assisting Biosphere Logic Encryption
Venus - Virtual Environment Network Unifying System
Verify - Vital Encryption Regulation Integration Formatting Yconia
Verse - Virtual Environmental Rendered System Expression
Vesica Piscis - Virtual Environment System Integrated Communication Application - Programed Integration System Commanding Intelligence Systems
Viable - Virtually Integrating Advanced Biosphereric Logistical Encryption
Victory - Vital Integrated Communication Terminal Operations Repairing Yconia | Virtual Intelligence Conditioning Transmuted Optimizing Repaired Yconia
Video - Visual Integration Designed Environment Observatory / Optimization / Observation
Vietnam - Virtually Integrated Environment Transmitting Neurological Advanced Multiverse
Viewing - Virtually Identifying Encrypted Watched Integrating Network Gate
Vile - Virtual / Vital Integrated / Intelligence Logic Error
Vine - Virtual Integrated Network Environment / Encryption
Violet - Virtual Intelligently Optimized Logic Environmental Transmission
Virginia - Virtual Integrated Reciprocating Gate Integrating Network Intelligence Application
Virtual - Vital Integrated Reciprocal Technologies Unifying Advanced Logic
Virtuoso - Verse Integration Routine Transmitting Universal Operations System Optimizer
Virus - Virtually Infecting Redistributed Unified Security
Vital - Virtual Intelligence Technological Application Logic
Vlog - Virtual Logistic Observation Gateway
Voice - Vibrational Optimized Intelligent Command Encoding
Vosk - Vatican Operating System / Security Key
Vote - Verified Opinion Tabulated Entry
VRIL - Virtual Rendering Integration Logic
Walk - Watching Application Logic / Logistical Keys
War - Wasting Allocated Resources | Watching Application Resources | Wrath Alloted Retribution
Warlock - Watching Applied Router Logistics Optimizing Communication Key Security
Warlord - Wasted Allocated Resources Logical Organizational Renovating Director 
Warp - Watched Advanced Rendering Program
Wash - Watching Applied System Holographic (Encrypted Design) (Integrating Neurologic Gate)
Washington D.C. - Watching Advanced Security Holographic Integration Neurologic Gate Transmission Operations Network (Design Controller)
Watching (to guard) – War Application Tactical Command Holographic Intelligence Network Gate
Water - Watched Application Terminating Environmental Religion (Water element aka Truth)
Weapon - Watching Environment Application Programming Offensive Neurologics / Network 
Weather - Watched Encrypted Transforming Holographic Environment Regulator
Web - Word / World Encrypted / Energetic Biosphere / Biometrics
Wednesday - Watched Environment Design Network Energy Security Data / Delta Analog / Accounting Yoke / Yconia
West - Watching Environmental System Transmission
Wet - Washed Entity / Encryption / Environment Termination
Whale - Water Habitat Animal Logos Entity
White - Watching Holographic Integration Terminal Environment
Why - Watching Holographic Yconia / Yoke / Yield
Windows - Watched Intelligent Neural Design Operational Word System
Winter - Weather Integration Network Transmitting Environmental Re synchronization
Wizard - Weaponized Integrated Zeus Advanced Research Designed System
Wonderland - World Operational Nexus Design Environment Recorded Logistical Application Network Design
Woo - World / Word Optimizing / Organizational / Ouroboros Operations 
Word - Watching / World Operating / Optimized Reality / Rendered Design
Works - Watching Operational Rendering Kingdom / Kryios Security
World - Watched Operational Rendered Logistics Design | Word Optimizing Rendered Logic Design
Worship - Watching Operational Religious Holographic Integration Processing
Wrath - Watching Reinforced Aggression Transmitting Hell
Xeno - X(Unknown descriptor/strange) Environmental / Energetic Neural Operator
YAHWEH - Yconia Application Holographics Watching Environmental Hologram
Yaldabaoth - Yconia Application Logic Designed Advanced Biometric Adam Optimized Transmitted Holographics
Yconia - Yielded Conditioned Optimized Network Image Application
Yehoshua - Yconia Environmental Hologram Operating Secure Holographic Unifying Application | Yconia Environmental Hologram Operator Securing Holographic Utility Application
Yellow - Yconia Environment Limited Logic Operational Watcher
Yeshua - Yconia Encryption Securing Hologram Utility Application 
YHWH - Yconia Holographics Watching Hologram
Yield - Yconia Integrated Encryption Logic Design / Data
Yoke - Yconia Optimizing Kinetic Energetics
You - Yconia Operational Universe
Y'shua - Yconia System Holographic Utility Application
Zeus - Z(Representing final/last) Energetically / Environmentally Unified System
Zionism - Zeus Integration Operational Network Intelligence System Mutation
Zone - Z(latest / last) Operational / Original Network / Neurological Extension / Encryption
Zoroaster - Zeus Optimized Rendering Operational Advanced Securely Transmitted Encryption Router
1 - One - Operational Neutral Energy
2 - Two - Transformational Watching Operation
3 - Three - Transforming Harmonious Recycled Energy Exchange | Transforming Holistic Regenerative Energy Environment
4 - Four - Finite Operational Unified Recycler
5 - Five - Finite Intelligent Virtual Energy
6 - Six - System Intelligent / Integrated Xeno
7 - Seven - System Energy Virtual Exchange Neutralizer
8 - Eight - Energy Intelligent Geo Harmonious Transformation
9 - Nine - Neutral Intelligent Neural Energy - Neural Integrated / Inclusive Network Environment
0 - Zero - Zeus Energy Recycle Operation
1 – One – Original Network Encryption
2 – Two – Transmission Watching Operations
3 – Three – Transmitting Holographic Rendering Environmental Encryption
4 – Four – Fractal Optimized Universal Receiver 
5 – Five – Formatting Integrated Virtual Environment
6 – Six – Signal Intelligence Xeno
7 – Seven – Secure Environment Virtual Encryption Network
8 – Eight – Energy Integrated Geometric Holographic Terminal
9 – Nine – Neurologic Integration Network Encryption
0 – Zero – Zeus Encrypted Replication Optimizer



















